# Input for gen_tests.sh
#
# Copyright (c) 2017-2025 The strace developers.
# All rights reserved.
#
# SPDX-License-Identifier: GPL-2.0-or-later

_newselect
_newselect-P	 -e trace=_newselect -P /dev/full 9>>/dev/full
accept	-a22
accept4	-a37
access	-a30 --trace-path=access_sample
access--secontext	-a30 --secontext --trace-path=access_sample -e trace=access
access--secontext_full	-a30 --secontext=full --trace-path=access_sample -e trace=access
access--secontext_full_mismatch	-a30 --secontext=full,mismatch --trace-path=access_sample -e trace=access
access--secontext_mismatch	-a30 --secontext=mismatch --trace-path=access_sample -e trace=access
acct	-a20
add_key	-a30 -s12
adjtimex	-a15
aio	-a14 -e trace=io_setup,io_submit,io_getevents,io_cancel,io_destroy
aio_pgetevents	-e trace=io_pgetevents
alarm	-a10
arch_prctl			+arch_prctl.sh -a27
arch_prctl-Xabbrev		+arch_prctl.sh -a27 -Xabbrev
arch_prctl-Xraw			+arch_prctl.sh -a17 -Xraw
arch_prctl-Xverbose		+arch_prctl.sh -a32 -Xverbose
arch_prctl-success		+prctl-success.sh ARCH_PRCTL_INJECT_RETVALS="0 1 2 3 0x20 0xc0 0xdead 0x20000 0x40000 0x60000 0x687ff 0x97800 0x789abcde" -a27
arch_prctl-success-Xabbrev	+prctl-success.sh ARCH_PRCTL_INJECT_RETVALS="0 1 2 3 0x20 0xc0 0xdead 0x20000 0x40000 0x60000 0x687ff 0x97800 0x789abcde" -a27 -Xabbrev
arch_prctl-success-Xraw		+prctl-success.sh ARCH_PRCTL_INJECT_RETVALS="0 1 2 3 0x20 0xc0 0xdead 0x20000 0x40000 0x60000 0x687ff 0x97800 0x789abcde" -a17 -Xraw
arch_prctl-success-Xverbose	+prctl-success.sh ARCH_PRCTL_INJECT_RETVALS="0 1 2 3 0x20 0xc0 0xdead 0x20000 0x40000 0x60000 0x687ff 0x97800 0x789abcde" -a32 -Xverbose
at_fdcwd-pathmax	-a36 --trace=openat -y -P sample
bpf	-a20
bpf-obj_get_info_by_fd	-a20 -y -e trace=bpf
bpf-obj_get_info_by_fd-prog	-a20 -y -e trace=bpf
bpf-obj_get_info_by_fd-prog-v	-a20 -y -v -e trace=bpf
bpf-obj_get_info_by_fd-v	-a20 -y -v -e trace=bpf
bpf-success	-einject=bpf:retval=42 -etrace=bpf -a20
bpf-success-v	-einject=bpf:retval=42 -etrace=bpf -a20 -v
bpf-v	-a20 -v -e trace=bpf
btrfs	+ioctl.test
cachestat	-a29 -y 9>>/dev/full
cachestat-P	-y --trace-path=/dev/full --trace=cachestat 9>>/dev/full
cachestat-fd	-y --trace-fds=9 --trace=cachestat 9>>/dev/full
cachestat-success --inject=cachestat:retval=42 -a29 --trace=cachestat 9>>/dev/full
chdir	-a10
chmod	-a28
chmod--secontext	-a28 -e secontext=!full,mismatch -e trace=chmod
chmod--secontext_full	-a28 -e secontext=full -e trace=chmod
chmod--secontext_full_mismatch	-a28 --secontext=mismatch,full -e trace=chmod
chmod--secontext_mismatch	-a28 --secontext=mismatch -e trace=chmod
chown	-a28
chown32	-a31
chroot	-a13
clock	test_trace_expr 'times|times-.*|fcntl.*' -e/clock
clock_adjtime	-a37
clock_adjtime64	-a39
clock_nanosleep	-e trace=clock_nanosleep,clock_gettime
clock_xettime	-a36 -e trace=clock_gettime,clock_settime,clock_getres
clock_xettime64	-a39 -e trace=clock_gettime64,clock_settime64,clock_getres_time64
clone3	-a16
clone3-Xabbrev	-a16 -Xabbrev  -e trace=clone3
clone3-Xraw	-a16 -Xraw     -e trace=clone3
clone3-Xverbose	-a16 -Xverbose -e trace=clone3
clone3-success	-einject=clone3:retval=42 -etrace=clone3 -a10
clone3-success-Xabbrev	-einject=clone3:retval=42 -etrace=clone3 -a16 -Xabbrev
clone3-success-Xraw	-einject=clone3:retval=42 -etrace=clone3 -a16 -Xraw
clone3-success-Xverbose	-einject=clone3:retval=42 -etrace=clone3 -a16 -Xverbose
clone_parent +clone_ptrace.test
clone_parent--quiet-exit +clone_ptrace.test --quiet=exit,personality
clone_parent-q +clone_ptrace.test -q
clone_parent-qq +clone_ptrace.test -qq
clone_ptrace--quiet-attach +clone_ptrace.test --quiet=attach,personality
clone_ptrace--quiet-exit +clone_ptrace.test --quiet=exit,personality
clone_ptrace-q +clone_ptrace.test -q
clone_ptrace-qq +clone_ptrace.test -qq
close_range	-a21 7>>/dev/full
copy_file_range
creat	-a16
delete_module	-a23
dev--decode-fds-all	-a30 -e trace=openat,fsync -P "/dev/full" -P "/dev/zero" -P "/dev/sda" -e decode-fds=all
dev--decode-fds-dev	-a30 -e trace=openat,fsync -P "/dev/full" -P "/dev/zero" -P "/dev/sda" -e decode-fds=dev
dev--decode-fds-none	-a9 -e trace=openat,fsync -P "/dev/full" -P "/dev/zero" -P "/dev/sda" --decode-fds=none
dev--decode-fds-path	-a19 -e trace=openat,fsync -P "/dev/full" -P "/dev/zero" -P "/dev/sda" -e decode-fds=path
dev--decode-fds-socket	-a9 -e trace=openat,fsync -P "/dev/full" -P "/dev/zero" -P "/dev/sda" --decode-fds=socket
dev-pty-yy require_min_kernel_version_or_skip 4.14; run_strace_match_diff -a30 -e trace=close -P "/dev/ptmx" -yy
dev-yy	-a30 -e trace=openat,fsync -P "/dev/full" -P "/dev/zero" -P "/dev/sda" -yy
dup	-a7 9>>/dev/full
dup-P	-a7 --trace=dup -P /dev/full 9>>/dev/full
dup-trace-fds-0		-a7 --trace=dup --trace-fds=0 9>>/dev/full
dup-trace-fds-0-9	-a7 --trace=dup --trace-fds=0,9 9>>/dev/full
dup-trace-fds-0-P	-a7 --trace=dup --trace-fds=0 -P /dev/full 9>>/dev/full
dup-trace-fds-not-9	-a7 --trace=dup --trace-fds='!9' 9>>/dev/full
dup-y	-a8 --trace=dup -y 9>>/dev/full
dup-yy	-a8 --trace=dup -yy 9>>/dev/full
dup2	-a11 9>>/dev/full
dup2-P	-a11 --trace=dup2 -P /dev/full 9>>/dev/full
dup2-e-fd-0	-a11 --trace=dup2 -e fd=0 9>>/dev/full
dup2-e-fd-0-9	-a11 --trace=dup2 -e fd=0,9 9>>/dev/full
dup2-e-fd-0-P	-a11 --trace=dup2 -e fd=0 -P /dev/full 9>>/dev/full
dup2-e-fd-not-9	-a11 --trace=dup2 -e fd='!9' 9>>/dev/full
dup2-y	-a13 --trace=dup2 -y 9>>/dev/full
dup2-yy	-a13 --trace=dup2 -yy 9>>/dev/full
dup3	-a13 7>>/dev/full
dup3-P	-a13 --trace=dup3 -P /dev/full 7>>/dev/full
dup3-y	-a15 --trace=dup3 -y 7>>/dev/full
dup3-yy	-a15 --trace=dup3 -yy 7>>/dev/full
epoll_create	-a17
epoll_create1	-a28
epoll_ctl
epoll_pwait
epoll_pwait2	9>>/dev/full
epoll_pwait2-P	--trace=epoll_pwait2 -P /dev/full 9>>/dev/full
epoll_pwait2-y	--trace=epoll_pwait2 -y 9>>/dev/full
epoll_wait	-a26
erestartsys	-a34 -e signal=none -e trace=recvfrom
eventfd-yy -a15 --trace=eventfd2,fchdir -yy -qq
eventfd--decode-fd-eventfd	-a15 --trace=eventfd2,fchdir --decode-fds=eventfd -qq
execve--secontext	+execve.test --secontext
execve--secontext_full	+execve.test --secontext=full
execve--secontext_full_mismatch	+execve.test --secontext=full,mismatch
execve--secontext_mismatch	+execve.test --secontext=mismatch
execveat
execveat--secontext	--secontext --trace=execveat
execveat--secontext_full	--secontext=full --trace=execveat
execveat--secontext_full_mismatch	--secontext=full,mismatch --trace=execveat
execveat--secontext_mismatch	--secontext=mismatch --trace=execveat
execveat-v	-v -e trace=execveat
faccessat--secontext	+faccessat.test -a24 --secontext
faccessat--secontext_full	+faccessat.test -a24 --secontext=full
faccessat--secontext_full_mismatch	+faccessat.test -a24 --secontext=full,mismatch
faccessat--secontext_mismatch	+faccessat.test -a24 --secontext=mismatch
faccessat-P	-a23 --trace=faccessat -P /dev/full
faccessat-y	+faccessat.test -a24 -y
faccessat-y--secontext	+faccessat.test -a24 -y --secontext
faccessat-y--secontext_full	+faccessat.test -a24 -y --secontext=full
faccessat-y--secontext_full_mismatch	+faccessat.test -a24 -y --secontext=full,mismatch
faccessat-y--secontext_mismatch	+faccessat.test -a24 -y --secontext=mismatch
faccessat-yy	+faccessat.test -a24 -yy
faccessat2-P	-a27 --trace=faccessat2 -P /dev/full
faccessat2-y	+faccessat2.test -a28 -y
faccessat2-yy	+faccessat2.test -a28 -yy
fadvise64_64	+fadvise64.test
fallocate	-a18
fanotify_init
fanotify_mark	-a32
fanotify_mark--secontext	-a32 --secontext -e trace=fanotify_mark
fanotify_mark--secontext_full	-a32 --secontext=full -e trace=fanotify_mark
fanotify_mark--secontext_full_mismatch	-a32 --secontext=full,mismatch -e trace=fanotify_mark
fanotify_mark--secontext_mismatch	-a32 --secontext=mismatch -e trace=fanotify_mark
fanotify_mark-Xabbrev	-a32 -Xabbrev -e trace=fanotify_mark
fanotify_mark-Xraw	-a32 -Xraw -e trace=fanotify_mark
fanotify_mark-Xverbose	-a32 -Xverbose -e trace=fanotify_mark
fchdir	-a11
fchmod	-a15
fchmod--secontext	-a15 --secontext -e trace=fchmod
fchmod--secontext_full	-a15 --secontext=full -e trace=fchmod
fchmod--secontext_full_mismatch	-a15 --secontext=full,mismatch -e trace=fchmod
fchmod--secontext_mismatch	-a15 --secontext=mismatch -e trace=fchmod
fchmod-y	-y -e trace=fchmod
fchmod-y--secontext	-a15 -y --secontext -e trace=fchmod
fchmod-y--secontext_full	-a15 -y --secontext=full -e trace=fchmod
fchmod-y--secontext_full_mismatch	-a15 -y --secontext=full,mismatch -e trace=fchmod
fchmod-y--secontext_mismatch	-a15 -y --secontext=mismatch -e trace=fchmod
fchmodat
fchmodat--secontext	--secontext -e trace=fchmodat
fchmodat--secontext_full	--secontext=full -e trace=fchmodat
fchmodat--secontext_full_mismatch	--secontext=full,mismatch -e trace=fchmodat
fchmodat--secontext_mismatch	--secontext=mismatch -e trace=fchmodat
fchmodat2
fchmodat2--secontext	--secontext -e trace=fchmodat2
fchmodat2--secontext_full	--secontext=full -e trace=fchmodat2
fchmodat2--secontext_full_mismatch	--secontext=full,mismatch -e trace=fchmodat2
fchmodat2--secontext_mismatch	--secontext=mismatch -e trace=fchmodat2
fchown	-a16
fchown32	-a18
fchownat
fchownat--secontext	--secontext -e trace=fchownat
fchownat--secontext_full	--secontext=full -e trace=fchownat
fchownat--secontext_full_mismatch	-e secontext=full,mismatch -e trace=fchownat
fchownat--secontext_mismatch	-e secontext=mismatch -e trace=fchownat
fcntl	-a8
fcntl--pidns-translation	test_pidns -a8 -e trace=fcntl
fcntl64	-a8
fcntl64--pidns-translation	test_pidns -a8 -e trace=fcntl64
fdatasync	-a14
file_handle	-e trace=name_to_handle_at,open_by_handle_at
file_handle--secontext	--secontext -e trace=name_to_handle_at,open_by_handle_at
file_handle--secontext_full	--secontext=full -e trace=name_to_handle_at,open_by_handle_at
file_handle--secontext_full_mismatch	--secontext=full,mismatch -e trace=name_to_handle_at,open_by_handle_at
file_handle--secontext_mismatch	--secontext=mismatch -e trace=name_to_handle_at,open_by_handle_at
filter_seccomp	. "${srcdir=.}/filter_seccomp.sh"; test_prog_set --seccomp-bpf -f
filter_seccomp-flag	../$NAME
finit_module	-a25
flock	-a19
fork-f	-a26 -qq -f -e signal=none -e trace=chdir
fsconfig	-s300 -y
fsconfig-P	-s300 -y -P /dev/full -e trace=fsconfig
fsmount	-a18 -y
fsopen	-a35
fspick	-a27 -y
fspick-P	-a27 -y -P /dev/full -e trace=fspick
fstat	-a15 -v -P stat.sample
fstat-Xabbrev -a15 -v -Xabbrev -P stat.sample -e trace=fstat
fstat-Xraw -a15 -v -Xraw -P stat.sample -e trace=fstat
fstat-Xverbose -a15 -v -Xverbose -P stat.sample -e trace=fstat
fstat64	-a17 -v -P stat.sample
fstat64-Xabbrev -a17 -Xabbrev -v -P stat.sample -e trace=fstat64
fstat64-Xraw -a17 -Xraw -v -P stat.sample -e trace=fstat64
fstat64-Xverbose -a17 -Xverbose -v -P stat.sample -e trace=fstat64
fstatat64	-a32 --no-abbrev --trace-path=stat.sample --trace-path=/dev/full
fstatfs	-a18
fstatfs64	-a24
fsync	-a10
fsync-y -y -e trace=fsync
ftruncate	-a24
ftruncate64	-a36
futex_requeue
futex_requeue-Xabbrev	--trace=futex_requeue -Xabbrev
futex_requeue-Xraw		--trace=futex_requeue -Xraw
futex_requeue-Xverbose	--trace=futex_requeue -Xverbose
futex_wait
futex_wait-Xabbrev	--trace=futex_wait -Xabbrev
futex_wait-Xraw		--trace=futex_wait -Xraw
futex_wait-Xverbose	--trace=futex_wait -Xverbose
futex_waitv	-s256
futex_wake
futex_wake-Xabbrev	--trace=futex_wake -Xabbrev
futex_wake-Xraw		--trace=futex_wake -Xraw -a34
futex_wake-Xverbose	--trace=futex_wake -Xverbose
futimesat	-a28
get_mempolicy	-s3 -a38
getcpu	-a25
getcwd	-a18
getdents	-a31
getdents-v	-a22 -v --trace=getdents
getdents64	-a33
getdents64-v	-a24 -v --trace=getdents64
getegid	+getuid.test
getegid-creds	+getuid.test
getegid32	+getuid.test
getegid32-creds	+getuid.test
geteuid	+getuid.test
geteuid-creds	+getuid.test
geteuid32	+getuid.test
geteuid32-creds	+getuid.test
getgid	+getuid.test
getgid-creds	+getuid.test
getgid32	+getuid.test
getgid32-creds	+getuid.test
getgroups	-a17
getgroups32	-a19
getpeername	-a27
getpgrp	-a10
getpgrp--pidns-translation	test_pidns -e trace=getpgrp -a10
getpid	-a9
getpid--pidns-translation	test_pidns -e trace=getpid -a9
getppid	-a10
getrandom	-a22 -s3 "QUIRK:START-OF-TEST-OUTPUT:getrandom(NULL, 0, 0)"
getresgid	-a25
getresgid32	-a27
getresuid	-a25
getresuid32	-a27
getrlimit	-a27 'QUIRK:START-OF-TEST-OUTPUT:getrlimit(0x10 /* RLIMIT_??? */, NULL)'
getrusage	-v
getsid	-a10
getsid--pidns-translation	test_pidns -e trace=getsid -a10
getsockname	-a27
getsockname--secontext	-a27 --secontext -e trace=getsockname
getsockname--secontext_full	-a27 --secontext=full -e trace=getsockname
getsockname--secontext_full_mismatch	-a27 --secontext=full,mismatch -e trace=getsockname
getsockname--secontext_mismatch	-a27 --secontext=mismatch -e trace=getsockname
gettid	-a9
getuid-creds	+getuid.test
getuid32	+getuid.test
getuid32-creds	+getuid.test
getxattrat
getxattrat-P	--trace=getxattrat -P /dev/full
getxattrat-y	--trace=getxattrat -y
getxattrat-yy	--trace=getxattrat -yy
getxgid	-a10
getxpid	-a10
getxuid	-a10
group_req	-e trace=setsockopt
inet-cmsg	-e trace=recvmsg
init_module	-a27
inotify	-a23 -e trace=inotify_add_watch,inotify_rm_watch
inotify_init	-a15
inotify_init1	-a27
inotify_init1-y	-a27 -y -e trace=inotify_init1
io_uring_enter	-y
io_uring_register	-y
io_uring_register-Xabbrev	-etrace=io_uring_register -y -Xabbrev
io_uring_register-Xraw		-etrace=io_uring_register -y -Xraw
io_uring_register-Xverbose	-etrace=io_uring_register -y -Xverbose
io_uring_register-success		-einject=io_uring_register:retval=42 -etrace=io_uring_register -y
io_uring_register-success-Xabbrev	-einject=io_uring_register:retval=42 -etrace=io_uring_register -y -Xabbrev
io_uring_register-success-Xraw		-einject=io_uring_register:retval=42 -etrace=io_uring_register -y -Xraw
io_uring_register-success-Xverbose	-einject=io_uring_register:retval=42 -etrace=io_uring_register -y -Xverbose
io_uring_setup	-a26 -y
ioctl-v	+ioctl.test -v
ioctl_block	+ioctl.test
ioctl_counter	+ioctl.test -a39
ioctl_counter-Xabbrev	+ioctl.test -a39 -Xabbrev
ioctl_counter-Xraw	+ioctl.test -a18 -Xraw
ioctl_counter-Xverbose	+ioctl.test -a52 -Xverbose
ioctl_dm	+ioctl.test -s9
ioctl_dm-v	+ioctl.test -v -s9
ioctl_epoll		+ioctl.test -a30
ioctl_epoll-Xabbrev	+ioctl.test -a30 -Xabbrev
ioctl_epoll-Xraw		+ioctl.test -a28 -Xraw
ioctl_epoll-Xverbose	+ioctl.test -a47 -Xverbose
ioctl_epoll-success		+ioctl-success.sh -a30
ioctl_epoll-success-Xabbrev	+ioctl-success.sh -a30 -Xabbrev
ioctl_epoll-success-Xraw		+ioctl-success.sh -a28 -Xraw
ioctl_epoll-success-Xverbose	+ioctl-success.sh -a47 -Xverbose
ioctl_evdev	+ioctl.test -a26
ioctl_evdev-Xabbrev	+ioctl.test -a26 -Xabbrev
ioctl_evdev-Xraw	+ioctl.test -a28 -Xraw
ioctl_evdev-Xverbose	+ioctl.test -a41 -Xverbose
ioctl_evdev-success-Xabbrev	+ioctl_evdev-success.test -Xabbrev
ioctl_evdev-success-Xraw	+ioctl_evdev-success.test -a27 -Xraw
ioctl_evdev-success-Xverbose	+ioctl_evdev-success.test -a43 -Xverbose
ioctl_evdev-success-v	+ioctl_evdev-success.test -a26 -v
ioctl_evdev-success-v-Xabbrev	+ioctl_evdev-success.test -v -Xabbrev
ioctl_evdev-success-v-Xraw	+ioctl_evdev-success.test -a27 -v -Xraw
ioctl_evdev-success-v-Xverbose	+ioctl_evdev-success.test -a43 -v -Xverbose
ioctl_evdev-v	+ioctl.test -a26 -v
ioctl_evdev-v-Xabbrev	+ioctl.test -a26 -v -Xabbrev
ioctl_evdev-v-Xraw	+ioctl.test -a28 -v -Xraw
ioctl_evdev-v-Xverbose	+ioctl.test -a41 -v -Xverbose
ioctl_fiemap	+ioctl.test
ioctl_fiemap-Xabbrev	+ioctl.test -Xabbrev
ioctl_fiemap-Xraw	+ioctl.test -Xraw
ioctl_fiemap-Xverbose	+ioctl.test -Xverbose
ioctl_fiemap-success	+ioctl-success.sh -a31
ioctl_fiemap-success-Xabbrev	+ioctl-success.sh -a31 -Xabbrev
ioctl_fiemap-success-Xraw	+ioctl-success.sh -a25 -Xraw
ioctl_fiemap-success-Xverbose	+ioctl-success.sh -a48 -Xverbose
ioctl_fiemap-success-v	+ioctl-success.sh -a31 -v
ioctl_fiemap-success-v-Xabbrev	+ioctl-success.sh -a31 -v -Xabbrev
ioctl_fiemap-success-v-Xraw	+ioctl-success.sh -a25 -v -Xraw
ioctl_fiemap-success-v-Xverbose	+ioctl-success.sh -a48 -v -Xverbose
ioctl_fs_f	+ioctl.test -a33
ioctl_fs_f-Xabbrev	+ioctl.test -a33 -Xabbrev
ioctl_fs_f-Xraw	+ioctl.test -a21 -Xraw
ioctl_fs_f-Xverbose	+ioctl.test -Xverbose
ioctl_fs_x	+ioctl.test -a18
ioctl_fs_x-Xabbrev	+ioctl.test -a18 -Xabbrev
ioctl_fs_x-Xraw	+ioctl.test -a21 -Xraw
ioctl_fs_x-Xverbose	+ioctl.test -a35 -Xverbose
ioctl_fs_x-success	+ioctl-success.sh -a18
ioctl_fs_x-success-Xabbrev	+ioctl-success.sh -a18 -Xabbrev
ioctl_fs_x-success-Xraw	+ioctl-success.sh -a21 -Xraw
ioctl_fs_x-success-Xverbose	+ioctl-success.sh -a35 -Xverbose
ioctl_gpio	+ioctl.test
ioctl_gpio-Xabbrev	+ioctl.test -Xabbrev
ioctl_gpio-Xraw	+ioctl.test -Xraw
ioctl_gpio-Xverbose	+ioctl.test -Xverbose
ioctl_gpio-success	+ioctl-success.sh -a30
ioctl_gpio-success-Xabbrev	+ioctl-success.sh -a30 -Xabbrev
ioctl_gpio-success-Xraw	+ioctl-success.sh -a20 -Xraw
ioctl_gpio-success-Xverbose	+ioctl-success.sh -a30 -Xverbose
ioctl_gpio-success-v	+ioctl-success.sh -a30 -v
ioctl_gpio-success-v-Xabbrev	+ioctl-success.sh -a30 -v -Xabbrev
ioctl_gpio-success-v-Xraw	+ioctl-success.sh -a20 -v -Xraw
ioctl_gpio-success-v-Xverbose	+ioctl-success.sh -a30 -v -Xverbose
ioctl_gpio-v	+ioctl.test -v
ioctl_gpio-v-Xabbrev	+ioctl.test -v -Xabbrev
ioctl_gpio-v-Xraw	+ioctl.test -v -Xraw
ioctl_gpio-v-Xverbose	+ioctl.test -v -Xverbose
ioctl_hdio	+ioctl.test -a27
ioctl_hdio-Xabbrev	+ioctl.test -a27 -Xabbrev
ioctl_hdio-Xraw	+ioctl.test -a20 -Xraw
ioctl_hdio-Xverbose	+ioctl.test -a39 -Xverbose
ioctl_hdio-success	+ioctl-success.sh -a27
ioctl_hdio-success-Xabbrev	+ioctl-success.sh -a27 -Xabbrev
ioctl_hdio-success-Xraw	+ioctl-success.sh -a20 -Xraw
ioctl_hdio-success-Xverbose	+ioctl-success.sh -a39 -Xverbose
ioctl_hdio-success-v	+ioctl-success.sh -a27 -v
ioctl_hdio-success-v-Xabbrev	+ioctl-success.sh -a27 -v -Xabbrev
ioctl_hdio-success-v-Xraw	+ioctl-success.sh -a20 -v -Xraw
ioctl_hdio-success-v-Xverbose	+ioctl-success.sh -a39 -v -Xverbose
ioctl_hdio-v	+ioctl.test -a27 -v
ioctl_hdio-v-Xabbrev	+ioctl.test -a27 -v -Xabbrev
ioctl_hdio-v-Xraw	+ioctl.test -a20 -v -Xraw
ioctl_hdio-v-Xverbose	+ioctl.test -a39 -v -Xverbose
ioctl_inotify	+ioctl.test
ioctl_kd		+ioctl.test -a20
ioctl_kd-Xabbrev	+ioctl.test -a20 -Xabbrev
ioctl_kd-Xraw		+ioctl.test -a18 -Xraw
ioctl_kd-Xverbose	+ioctl.test -a20 -Xverbose
ioctl_kd-success		+ioctl-success.sh -a20
ioctl_kd-success-Xabbrev	+ioctl-success.sh -a20 -Xabbrev
ioctl_kd-success-Xraw		+ioctl-success.sh -a18 -Xraw
ioctl_kd-success-Xverbose	+ioctl-success.sh -a20 -Xverbose
ioctl_kd-success-s1024		+ioctl-success.sh -a20 -s1024
ioctl_kd-success-s1024-Xabbrev	+ioctl-success.sh -a20 -s1024 -Xabbrev
ioctl_kd-success-s1024-Xraw	+ioctl-success.sh -a18 -s1024 -Xraw
ioctl_kd-success-s1024-Xverbose	+ioctl-success.sh -a20 -s1024 -Xverbose
ioctl_kvm_run	+ioctl.test -a36 -y
ioctl_kvm_run-v	+ioctl.test -v -a36 -y
ioctl_kvm_run_auxstr_vcpu	+ioctl.test -a36 -y -e kvm=vcpu
ioctl_lirc	+ioctl-success.sh -a30
ioctl_lirc-success	+ioctl-success.sh -a30
ioctl_loop	+ioctl.test
ioctl_loop-nv	+ioctl.test -a22 -e verbose=none
ioctl_loop-v	+ioctl.test -v
ioctl_mtd	+ioctl.test
ioctl_mtd-success	+ioctl-success.sh -a26
ioctl_nbd	+ioctl.test -y
ioctl_nsfs	+ioctl.test -esignal=none
ioctl_nsfs-ns_get_pid	+ioctl.test -a33
ioctl_nsfs-ns_get_pid--pidns-translation	test_pidns -etrace=ioctl -a25 "QUIRK:START-OF-TEST-OUTPUT:ioctl(-1, NS_GET_USERNS)"
ioctl_nsfs-ns_mnt_get	+ioctl.test
ioctl_perf	+ioctl.test
ioctl_perf-success +ioctl-success.sh -a35
ioctl_ptp			+ioctl.test -a29
ioctl_ptp-Xabbrev		+ioctl.test -a29 -Xabbrev
ioctl_ptp-Xraw			+ioctl.test -a20 -s51 -Xraw
ioctl_ptp-Xverbose		+ioctl.test -a46 -s51 -Xverbose
ioctl_ptp-success		+ioctl-success.sh -a29
ioctl_ptp-success-Xabbrev	+ioctl-success.sh -a29 -Xabbrev
ioctl_ptp-success-Xraw		+ioctl-success.sh -a20 -s51 -Xraw
ioctl_ptp-success-Xverbose	+ioctl-success.sh -a46 -s51 -Xverbose
ioctl_random	+ioctl.test
ioctl_rtc	+ioctl.test
ioctl_rtc-success	+ioctl-success.sh -a22
ioctl_rtc-v	+ioctl.test -v
ioctl_scsi	+ioctl.test
ioctl_seccomp						+ioctl.test -a42
ioctl_seccomp--pidns-translation			test_pidns -etrace=ioctl "QUIRK:START-OF-TEST-OUTPUT:ioctl(-1, SECCOMP_IOCTL_NOTIF_RECV, NULL)" "QUIRK:PROG-ARGS:256 42" -a48
ioctl_seccomp-success					+ioctl-success.sh -a42
ioctl_seccomp-y						+ioctl.test -a42 -y
ioctl_seccomp-y-success					+ioctl-success.sh -a42 -y
ioctl_seccomp-y-success--pidns-translation		check_scno_tampering; test_pidns -einject=ioctl:when=256+:retval=42 -etrace=ioctl "QUIRK:START-OF-TEST-OUTPUT:ioctl(-1, SECCOMP_IOCTL_NOTIF_RECV, NULL)" "QUIRK:PROG-ARGS:256 42" -y -a48
ioctl_seccomp-y-success--pidns-translation-Xabbrev	check_scno_tampering; test_pidns -einject=ioctl:when=256+:retval=42 -etrace=ioctl "QUIRK:START-OF-TEST-OUTPUT:ioctl(-1, SECCOMP_IOCTL_NOTIF_RECV, NULL)" "QUIRK:PROG-ARGS:256 42" -y -a48 -Xabbrev
ioctl_seccomp-y-success--pidns-translation-Xraw		check_scno_tampering; test_pidns -einject=ioctl:when=256+:retval=42 -etrace=ioctl "QUIRK:START-OF-TEST-OUTPUT-REGEX:ioctl(-1, 0x[0-9a-f]*, NULL)" "QUIRK:PROG-ARGS:256 42" -y -a31 -Xraw
ioctl_seccomp-y-success--pidns-translation-Xverbose	check_scno_tampering; test_pidns -einject=ioctl:when=256+:retval=42 -etrace=ioctl "QUIRK:START-OF-TEST-OUTPUT-REGEX:ioctl(-1, 0x[0-9a-f]* /\* SECCOMP_IOCTL_NOTIF_RECV \*/, NULL)" "QUIRK:PROG-ARGS:256 42" -y -a65 -Xverbose
ioctl_seccomp-y-success-Xabbrev				+ioctl-success.sh -a42 -y -Xabbrev
ioctl_seccomp-y-success-Xraw				+ioctl-success.sh -a25 -y -Xraw
ioctl_seccomp-y-success-Xverbose			+ioctl-success.sh -a59 -y -Xverbose
ioctl_sg_io_v3	+ioctl.test
ioctl_sg_io_v4	+ioctl.test
ioctl_sock	+ioctl.test -a23
ioctl_sock_gifconf	+ioctl.test -a28 -s1
ioctl_tee	+ioctl.test
ioctl_termios	+ioctl.test
ioctl_termios-v	+ioctl.test -v
ioctl_tiocm	+ioctl.test
ioctl_ubi	+ioctl.test
ioctl_ubi-success	+ioctl-success.sh -a24
ioctl_uffdio	+ioctl.test
ioctl_v4l2	+ioctl.test
ioctl_v4l2-Xabbrev	+ioctl.test -Xabbrev
ioctl_v4l2-Xraw	+ioctl.test -Xraw
ioctl_v4l2-Xverbose	+ioctl.test -Xverbose
ioctl_v4l2-success	+ioctl-success.sh -a29
ioctl_v4l2-success-Xabbrev	+ioctl-success.sh -a29 -Xabbrev
ioctl_v4l2-success-Xraw	+ioctl-success.sh -a27 -Xraw
ioctl_v4l2-success-Xverbose	+ioctl-success.sh -a30 -Xverbose
ioctl_v4l2-success-v	+ioctl-success.sh -a29 -v
ioctl_v4l2-success-v-Xabbrev	+ioctl-success.sh -a29 -v -Xabbrev
ioctl_v4l2-success-v-Xraw	+ioctl-success.sh -a27 -v -Xraw
ioctl_v4l2-success-v-Xverbose	+ioctl-success.sh -a29 -v -Xverbose
ioctl_v4l2-v	+ioctl.test -v
ioctl_v4l2-v-Xabbrev	+ioctl.test -v -Xabbrev
ioctl_v4l2-v-Xraw	+ioctl.test -v -Xraw
ioctl_v4l2-v-Xverbose	+ioctl.test -v -Xverbose
ioctl_watchdog	+ioctl.test -a14
ioctl_watchdog-success	+ioctl-success.sh -a14
ioctl_watchdog-success-v	+ioctl-success.sh -a14 -v
ioctl_winsize	+ioctl.test
ioperm	-a27
iopl	-a8
ioprio	-a18 -e trace=ioprio_get,ioprio_set
ioprio--pidns-translation	test_pidns -a18 -e trace=ioprio_get,ioprio_set
ioprio-Xabbrev	-a18 -e trace=ioprio_get,ioprio_set -Xabbrev
ioprio-Xraw	-a18 -e trace=ioprio_get,ioprio_set -Xraw
ioprio-Xverbose	-a18 -e trace=ioprio_get,ioprio_set -Xverbose
ip_local_port_range			-e trace=getsockopt,setsockopt -a50
ip_local_port_range-Xabbrev		-e trace=getsockopt,setsockopt -Xabbrev -a50
ip_local_port_range-Xraw		-e trace=getsockopt,setsockopt -Xraw -a30
ip_local_port_range-Xverbose		-e trace=getsockopt,setsockopt -Xverbose -a69
ip_local_port_range-success		-einject=getsockopt,setsockopt:retval=42 -etrace=getsockopt,setsockopt -a50
ip_local_port_range-success-Xabbrev	-einject=getsockopt,setsockopt:retval=42 -etrace=getsockopt,setsockopt -Xabbrev -a50
ip_local_port_range-success-Xraw	-einject=getsockopt,setsockopt:retval=42 -etrace=getsockopt,setsockopt -Xraw -a30
ip_local_port_range-success-Xverbose	-einject=getsockopt,setsockopt:retval=42 -etrace=getsockopt,setsockopt -Xverbose -a69
ip_mreq	-e trace=setsockopt
ip_protocol		-einject=getsockopt:retval=42 -etrace=getsockopt -a52
ip_protocol-Xabbrev	-einject=getsockopt:retval=42 -etrace=getsockopt -a52 -Xabbrev
ip_protocol-Xraw	-einject=getsockopt:retval=42 -etrace=getsockopt -a36 -Xraw
ip_protocol-Xverbose	-einject=getsockopt:retval=42 -etrace=getsockopt -a71 -Xverbose
ipc	-a19
ipc_msg	+ipc.sh -a26
ipc_msg-Xabbrev	+ipc.sh -Xabbrev -a26
ipc_msg-Xraw	+ipc.sh -Xraw -a16
ipc_msg-Xverbose	+ipc.sh -Xverbose -a34
ipc_msgbuf-Xabbrev	+ipc_msgbuf.test -Xabbrev
ipc_msgbuf-Xraw	+ipc_msgbuf.test -Xraw -a19
ipc_msgbuf-Xverbose	+ipc_msgbuf.test -Xverbose
ipc_sem	+ipc.sh -a29
ipc_sem-Xabbrev	+ipc.sh -Xabbrev -a29
ipc_sem-Xraw	+ipc.sh -Xraw -a19
ipc_sem-Xverbose	+ipc.sh -Xverbose -a36
ipc_shm	+ipc.sh -a26
ipc_shm-Xabbrev	+ipc.sh -Xabbrev -a26
ipc_shm-Xraw	+ipc.sh -Xraw -a19
ipc_shm-Xverbose	+ipc.sh -Xverbose -a34
kcmp	-a22
kcmp-y	-a22 -y -e trace=kcmp
kcmp-y--pidns-translation	test_pidns -a22 -y -e trace=kcmp
kern_features -a16
kernel_version	-a16 -v -e trace=bpf
kernel_version-Xabbrev	-a16 -Xabbrev -v -e trace=bpf
kernel_version-Xraw	-a16 -Xraw -v -e trace=bpf
kernel_version-Xverbose	-a16 -Xverbose -v -e trace=bpf
kexec_file_load	-s9
kexec_load	-s9
keyctl	-a31 -s10 -f --signal='!chld'
keyctl-Xabbrev	-a31 -s10 -f --signal='!chld' -e trace=keyctl -Xabbrev
keyctl-Xraw	-a13 -s10 -f --signal='!chld' -e trace=keyctl -Xraw
keyctl-Xverbose	-a41 -s10 -f --signal='!chld' -e trace=keyctl -Xverbose
kill	-a12 -esignal=none
kill--pidns-translation	test_pidns -a12 -e trace=kill -esignal=none
ksysent	../$NAME
landlock_add_rule -a57
landlock_add_rule-y -a57 -y -e trace=landlock_add_rule </dev/null 7>/dev/zero 8>/dev/full
landlock_create_ruleset -a36
landlock_create_ruleset-success -einject=landlock_create_ruleset:retval=7 -etrace=landlock_create_ruleset -a10 7>/dev/null
landlock_create_ruleset-success-y -einject=landlock_create_ruleset:retval=7 -etrace=landlock_create_ruleset -a10 -y 7>/dev/null
landlock_create_ruleset-y -a36 -y -e trace=landlock_create_ruleset
landlock_restrict_self -a29
landlock_restrict_self-y -a29 -y -e trace=landlock_restrict_self 7>/dev/full
lchown	-a30
lchown32	-a32
link	-a17
link-P	-a17 -e trace=link -P link_sample_old
linkat
linkat--secontext	--secontext -e trace=linkat
linkat--secontext_full	--secontext=full -e trace=linkat
linkat--secontext_full_mismatch	--secontext=full,mismatch -e trace=linkat
linkat--secontext_mismatch	--secontext=mismatch -e trace=linkat
listmount	-a26
listmount-success --inject=listmount:retval=42 -a26 --trace=listmount
listxattrat	-a34
listxattrat-P	-a34 --trace=listxattrat -P /dev/full
listxattrat-y	-a34 --trace=listxattrat -y
listxattrat-yy	-a34 --trace=listxattrat -yy
lookup_dcookie	-a27
lsm_get_self_attr	-a49 -s2
lsm_get_self_attr-success	--inject=lsm_get_self_attr:retval=96 -a49 -s2 --trace=lsm_get_self_attr
lsm_list_modules	-a32
lsm_list_modules-success	--inject=lsm_list_modules:retval=18 -a32 --trace=lsm_list_modules
lsm_set_self_attr	-a46
lstat	-a31 --no-abbrev --trace-path=stat.sample --trace-path=/dev/full
lstat64	-a32 --no-abbrev --trace-path=stat.sample --trace-path=/dev/full
madvise	-a31
madvise-Xabbrev		--trace=madvise -a31 -Xabbrev
madvise-Xraw		--trace=madvise -a23 -Xraw
madvise-Xverbose	--trace=madvise -a40 -Xverbose
map_shadow_stack	-a29
map_shadow_stack-Xabbrev	--trace=map_shadow_stack -a29 -Xabbrev
map_shadow_stack-Xraw		--trace=map_shadow_stack -a29 -Xraw
map_shadow_stack-Xverbose	--trace=map_shadow_stack -a29 -Xverbose
maybe_switch_current_tcp	-a30 -f -e trace=execveat
maybe_switch_current_tcp--quiet-thread-execve	-a30 -s48 -f -e trace=execveat --quiet=personality,thread-execve
mbind
mbind-Xabbrev	-Xabbrev -e trace=mbind
mbind-Xraw	-a33 -Xraw -e trace=mbind
mbind-Xverbose	-Xverbose -e trace=mbind
membarrier	-a36
memfd_create	-s256
memfd_create-Xabbrev	-s256 -Xabbrev -e trace=memfd_create
memfd_create-Xraw	-a30 -s256 -Xraw -e trace=memfd_create
memfd_create-Xverbose	-s256 -Xverbose -e trace=memfd_create
memfd_secret -a16
memfd_secret-success -einject=memfd_secret:retval=7 -a16 -etrace=memfd_secret 7> /dev/null
memfd_secret-success-y -einject=memfd_secret:retval=7 -a16 -etrace=memfd_secret -y 7> /dev/null
migrate_pages	-a33
migrate_pages--pidns-translation	test_pidns -a33 -e trace=migrate_pages
mincore	-a22
mkdir	-a16
mkdirat	-a22
mknod	-a18
mknodat	-a35
mlock	-a20 -e trace=mlock,munlock
mlock2
mlockall	-a12
mmap-Xabbrev	+mmap.test abbrev
mmap-Xraw	+mmap.test raw 14
mmap-Xverbose	+mmap.test verbose
mmap64	+mmap.test
mmap64-Xabbrev	+mmap.test abbrev
mmap64-Xraw	+mmap.test raw 14
mmap64-Xverbose	+mmap.test verbose
mmsg	-e read=0 -e write=1 -e trace=recvmmsg,sendmmsg
mmsg-silent	-a25 -e verbose=none -e trace=sendmmsg,recvmmsg
mmsg_name	-a25 -e trace=sendmmsg,recvmmsg
mmsg_name-v	-v -a25 -e trace=sendmmsg,recvmmsg
modify_ldt	-a23
mount		-a33
mount-Xabbrev	-a33 -e trace=mount -Xabbrev
mount-Xraw	-a33 -e trace=mount -Xraw
mount-Xverbose	-a33 -e trace=mount -Xverbose
mount_setattr	-y 9>>/dev/full
mount_setattr-P	-y -P /dev/full -e trace=mount_setattr 9>>/dev/full
move_mount	-y
move_mount-P	-y -P /dev/full -e trace=move_mount
move_pages	-s3
move_pages--pidns-translation	test_pidns -s3 -e trace=move_pages
move_pages-Xabbrev	-s3 -e trace=move_pages -Xabbrev
move_pages-Xraw	-s3 -a36 -e trace=move_pages -Xraw
move_pages-Xverbose	-s3 -e trace=move_pages -Xverbose
mq	-a32 -e trace=mq_getsetattr,mq_open,mq_unlink
mq_sendrecv	-a14 -e trace=mq_open,mq_notify,mq_timedsend,mq_timedreceive,mq_unlink
mq_sendrecv-read	-eread=0 -a14 -e trace=mq_open,mq_notify,mq_timedsend,mq_timedreceive,mq_unlink
mq_sendrecv-write	-ewrite=0 -a14 -e trace=mq_open,mq_notify,mq_timedsend,mq_timedreceive,mq_unlink
mseal
msg_control	-a21 -e trace=sendmsg
msg_control-v	-v -a21 -e trace=sendmsg
msg_name	-a20 -e trace=recvmsg
munlockall	-a13
nanosleep	-a20
net--decode-fds-all-netlink	+net-yy-netlink.test --decode-fds=all
net--decode-fds-dev-netlink	+net-yy-netlink.test --decode-fds=dev -a9
net--decode-fds-none-netlink	+net-yy-netlink.test --decode-fds=none -a9
net--decode-fds-path-netlink	+net-yy-netlink.test --decode-fds=path
net--decode-fds-socket-netlink	+net-yy-netlink.test --decode-fds=socket
net-icmp_filter	-e trace=getsockopt,setsockopt
net-packet_mreq -e trace=setsockopt
net-packet_mreq-Xabbrev	-e trace=setsockopt -Xabbrev
net-packet_mreq-Xraw	-e trace=setsockopt -Xraw
net-packet_mreq-Xverbose	-e trace=setsockopt -Xverbose
net-sockaddr	-a24 -e trace=connect
net-sockaddr--pidns-translation	test_pidns -a24 -e trace=connect
net-tpacket_req -e trace=setsockopt
net-tpacket_stats -e trace=getsockopt
net-tpacket_stats-success -einject=getsockopt:retval=42 -etrace=getsockopt
net-yy-inet6	+net-yy-inet.test
netlink_audit	+netlink_sock_diag.test
netlink_crypto	+netlink_sock_diag.test
netlink_generic	+netlink_sock_diag.test
netlink_kobject_uevent	+netlink_sock_diag.test
netlink_netfilter	+netlink_sock_diag.test
netlink_nlctrl	+netlink_sock_diag.test
netlink_protocol	+netlink_sock_diag.test
netlink_route	+netlink_sock_diag.test
netlink_selinux	+netlink_sock_diag.test
netlink_xfrm	+netlink_sock_diag.test
newfstatat	-a32 --no-abbrev --trace-path=stat.sample --trace-path=/dev/full
nfnetlink_acct			+netlink_sock_diag.test
nfnetlink_cthelper		+netlink_sock_diag.test
nfnetlink_ctnetlink		+netlink_sock_diag.test
nfnetlink_ctnetlink_exp		+netlink_sock_diag.test
nfnetlink_cttimeout		+netlink_sock_diag.test
nfnetlink_ipset			+netlink_sock_diag.test
nfnetlink_nft_compat		+netlink_sock_diag.test
nfnetlink_nftables		+netlink_sock_diag.test
nfnetlink_osf			+netlink_sock_diag.test
nfnetlink_queue			+netlink_sock_diag.test
nfnetlink_ulog			+netlink_sock_diag.test
nlattr		+netlink_sock_diag.test
nlattr_br_port_msg		+netlink_sock_diag.test
nlattr_cachereport		+netlink_sock_diag.test
nlattr_cachereport-Xabbrev	+netlink_sock_diag.test -Xabbrev
nlattr_cachereport-Xraw		+netlink_sock_diag.test -Xraw
nlattr_cachereport-Xverbose	+netlink_sock_diag.test -Xverbose
nlattr_crypto_user_alg		+netlink_sock_diag.test
nlattr_dcbmsg			+netlink_sock_diag.test
nlattr_fib_rule_hdr		+netlink_sock_diag.test
nlattr_ifaddrlblmsg		+netlink_sock_diag.test
nlattr_ifaddrmsg		+netlink_sock_diag.test
nlattr_ifinfomsg		+netlink_sock_diag.test
nlattr_ifla_af_spec		+netlink_sock_diag.test
nlattr_ifla_brport		+netlink_sock_diag.test
nlattr_ifla_brport-Xabbrev	+netlink_sock_diag.test -Xabbrev
nlattr_ifla_brport-Xraw		+netlink_sock_diag.test -Xraw
nlattr_ifla_brport-Xverbose	+netlink_sock_diag.test -Xverbose
nlattr_ifla_linkinfo		+netlink_sock_diag.test
nlattr_ifla_port		+netlink_sock_diag.test
nlattr_ifla_protinfo		+netlink_sock_diag.test
nlattr_ifla_protinfo-Xabbrev	+netlink_sock_diag.test -Xabbrev
nlattr_ifla_protinfo-Xraw	+netlink_sock_diag.test -Xraw
nlattr_ifla_protinfo-Xverbose	+netlink_sock_diag.test -Xverbose
nlattr_ifla_proto_down_reason	+netlink_sock_diag.test
nlattr_ifla_vfinfo		+netlink_sock_diag.test
nlattr_ifla_vfinfo-Xabbrev	+netlink_sock_diag.test -Xabbrev
nlattr_ifla_vfinfo-Xraw		+netlink_sock_diag.test -Xraw
nlattr_ifla_vfinfo-Xverbose	+netlink_sock_diag.test -Xverbose
nlattr_ifla_xdp			+netlink_sock_diag.test
nlattr_ifla_xdp-y		+netlink_sock_diag.test -y; exec 9</dev/full
nlattr_ifstats			+netlink_sock_diag.test
nlattr_ifstats-Xabbrev		+netlink_sock_diag.test -Xabbrev
nlattr_ifstats-Xraw		+netlink_sock_diag.test -Xraw
nlattr_ifstats-Xverbose		+netlink_sock_diag.test -Xverbose
nlattr_inet_diag_msg		+netlink_sock_diag.test
nlattr_inet_diag_req_compat	+netlink_sock_diag.test
nlattr_inet_diag_req_v2		+netlink_sock_diag.test
nlattr_mdba_mdb_entry		+netlink_sock_diag.test
nlattr_mdba_router_port		+netlink_sock_diag.test
nlattr_ndmsg			+netlink_sock_diag.test
nlattr_ndtmsg			+netlink_sock_diag.test
nlattr_netconfmsg		+netlink_sock_diag.test
nlattr_netlink_diag_msg		+netlink_sock_diag.test
nlattr_nhmsg			+netlink_sock_diag.test
nlattr_nhmsg-Xabbrev		+netlink_sock_diag.test -Xabbrev
nlattr_nhmsg-Xraw		+netlink_sock_diag.test -Xraw
nlattr_nhmsg-Xverbose		+netlink_sock_diag.test -Xverbose
nlattr_nlmsgerr			+netlink_sock_diag.test
nlattr_packet_diag_msg		+netlink_sock_diag.test -v
nlattr_rtgenmsg			+netlink_sock_diag.test
nlattr_rtmsg			+netlink_sock_diag.test
nlattr_smc_diag_msg		+netlink_sock_diag.test
nlattr_tc_stats			+netlink_sock_diag.test
nlattr_tca_stab			+netlink_sock_diag.test
nlattr_tcamsg			+netlink_sock_diag.test
nlattr_tcamsg-Xabbrev		+netlink_sock_diag.test -Xabbrev
nlattr_tcamsg-Xraw		+netlink_sock_diag.test -Xraw
nlattr_tcamsg-Xverbose		+netlink_sock_diag.test -Xverbose
nlattr_tcmsg			+netlink_sock_diag.test
nlattr_unix_diag_msg		+netlink_sock_diag.test
old_mmap	-a11 -e trace=mmap
old_mmap-P	-e trace=mmap -P "/dev/full" 9>>/dev/full
old_mmap-Xabbrev	-a11 -e trace=mmap -Xabbrev
old_mmap-Xraw	-a11 -e trace=mmap -Xraw
old_mmap-Xverbose	-a11 -e trace=mmap -Xverbose
old_mmap-v-none	-a11 -e trace=mmap -e verbose=none
oldfstat	-a18 -v -P stat.sample
oldlstat	-a32 -v -P stat.sample -P /dev/full
oldselect	-a13 -e trace=select
oldselect-P	-a13 -e trace=select -P /dev/full 9>>/dev/full
oldselect-efault	-a13 -e trace=select
oldselect-efault-P	-a13 -e trace=select -P /dev/full 9>>/dev/full
oldstat	-a32 -v -P stat.sample -P /dev/full
open	-a30 -P $NAME.sample
open--secontext		-a30 -P open.sample --secontext --trace=open
open--secontext_full	-a30 -P open.sample --secontext=full --trace=open
open--secontext_full_mismatch	-a30 -P open.sample --secontext=full,mismatch --trace=open
open--secontext_mismatch		-a30 -P open.sample --secontext=mismatch --trace=open
open_tree -a30 -y
open_tree-P -a30 --decode-fds -P /dev/full -e trace=open_tree
openat	-a36 -P openat.sample
openat--secontext	-a34 -P openat.sample -P /proc/self -P /proc/self/root/proc/self -P /proc/self/root -P /proc/self/root/proc/self/root -P /proc/self/fd/0 -P ./proc/self/openat.sample -P ./proc/selfish/openat.sample --secontext -e trace=openat
openat--secontext_full	-a34 -P openat.sample -P /proc/self -P /proc/self/root/proc/self -P /proc/self/root -P /proc/self/root/proc/self/root -P /proc/self/fd/0 -P ./proc/self/openat.sample -P ./proc/selfish/openat.sample --secontext=full -e trace=openat
openat--secontext_full_mismatch	-a34 -P openat.sample -P /proc/self -P /proc/self/root/proc/self -P /proc/self/root -P /proc/self/root/proc/self/root -P /proc/self/fd/0 -P ./proc/self/openat.sample -P ./proc/selfish/openat.sample --secontext=full,mismatch -e trace=openat
openat--secontext_mismatch	-a34 -P openat.sample -P /proc/self -P /proc/self/root/proc/self -P /proc/self/root -P /proc/self/root/proc/self/root -P /proc/self/fd/0 -P ./proc/self/openat.sample -P ./proc/selfish/openat.sample --secontext=mismatch -e trace=openat
openat2	-a35
openat2-Xabbrev	--trace=openat2 -a35 -Xabbrev
openat2-Xraw	--trace=openat2 -a32 -Xraw
openat2-Xverbose	--trace=openat2 -a35 -Xverbose
openat2-v	--trace=openat2 -a35 -v
openat2-v-y	--trace=openat2 -a36 -v -y </dev/full
openat2-v-y-Xabbrev	--trace=openat2 -a35 -v -y -Xabbrev </dev/full
openat2-v-y-Xraw	--trace=openat2 -a32 -v -y -Xraw </dev/full
openat2-v-y-Xverbose	--trace=openat2 -a44 -v -y -Xverbose </dev/full
openat2-y	--trace=openat2 -a36 -y </dev/full
orphaned_process_group	. "${srcdir=.}/PTRACE_SEIZE.sh"; run_strace_match_diff -f -e trace=none -e signal='!chld'
osf_utimes	-a21
pause	-a8 -esignal=none
perf_event_open	-a1
perf_event_open_nonverbose	-a34 -e verbose=none -e trace=perf_event_open
perf_event_open_unabbrev	-a1 -v -e trace=perf_event_open
personality-Xabbrev	+personality.test -Xabbrev
personality-Xraw	+personality.test -a15 -Xraw
personality-Xverbose	+personality.test -Xverbose
pidfd_getfd	-a18 -Xverbose -e signal=none </dev/full
pidfd_getfd-y	--trace=pidfd_getfd -a18 -e signal=none -y </dev/full
pidfd_getfd-yy	--trace=pidfd_getfd -a18 -e signal=none -yy </dev/full
pidfd_open	-a17
pidfd_open--decode-fd-all	-a17 -e decode-fd=all -e trace=pidfd_open
pidfd_open--decode-fd-none	-a17 -e decode-fd=none -e trace=pidfd_open
pidfd_open--decode-fd-path	-a17 -e decode-fd=path -e trace=pidfd_open
pidfd_open--decode-fd-pidfd	-a17 -e decode-fd=pidfd -e trace=pidfd_open
pidfd_open--decode-fd-socket	-a17 -e decode-fd=socket -e trace=pidfd_open
pidfd_open--pidns-translation	test_pidns -a17 -e trace=pidfd_open
pidfd_open-P	-a17 -P /dev/full -e trace=pidfd_open
pidfd_open-y	-a17 -y -e trace=pidfd_open
pidfd_open-yy	-a17 -yy -e trace=pidfd_open
pidfd_send_signal
pidfd_send_signal--pidns-translation test_pidns -e trace=pidfd_send_signal
pipe2	-a15
pkey_alloc	-a17
pkey_free	-a13
pkey_mprotect	-a37
poke-sendfile	--inject=all:poke_enter=@arg3=0000000000000000:poke_exit=@arg3=ffffffffffffffff --trace=/sendfile
ppoll				-s2
ppoll-P				-s2 -e trace=ppoll -P /dev/full 9>>/dev/full
ppoll-e-trace-fds-23		-s2 -e trace=ppoll -e trace-fds=23
ppoll-e-trace-fds-23-42		-s2 -e trace=ppoll -e trace-fds=23,42
ppoll-e-trace-fds-not-9-42-P	-s2 -e trace=ppoll -e trace-fds='!9,42' -P /dev/full 9>>/dev/full
ppoll-v				-v -s2 -e trace=ppoll
prctl-arg2-intptr	+prctl.sh -a25
prctl-cap-ambient	+prctl.sh -a21
prctl-capbset		+prctl.sh -a21
prctl-dumpable		+prctl.sh -a23
prctl-fp-mode		+prctl-success.sh PRCTL_INJECT_RETVALS="error=ENOTTY 0 1 2 3 32 35" -a21
prctl-mce-kill		+prctl.sh -a21
prctl-mdwe		+prctl-success.sh PRCTL_INJECT_RETVALS="error=ENOTTY 0 1 2 3 2124532476" -a31
prctl-name		+prctl.sh -a23
prctl-no-args		+prctl.sh -a21
prctl-no-args-Xabbrev	+prctl.sh -a21 -Xabbrev
prctl-no-args-Xraw	+prctl.sh -a11 -Xraw
prctl-no-args-Xverbose	+prctl.sh -a31 -Xverbose
prctl-no-args-success		+prctl-success.sh PRCTL_INJECT_RETVALS="0 1 2 3 4 8 16 32 64 128 256 4096 65536 16777216 2124532476" -a21
prctl-no-args-success-Xabbrev	+prctl-success.sh PRCTL_INJECT_RETVALS="0 1 2 3 4 8 16 32 64 128 256 4096 65536 16777216 2124532476" -a21 -Xabbrev
prctl-no-args-success-Xraw	+prctl-success.sh PRCTL_INJECT_RETVALS="0 1 2 3 4 8 16 32 64 128 256 4096 65536 16777216 2124532476" -a11 -Xraw
prctl-no-args-success-Xverbose	+prctl-success.sh PRCTL_INJECT_RETVALS="0 1 2 3 4 8 16 32 64 128 256 4096 65536 16777216 2124532476" -a31 -Xverbose
prctl-pac-enabled-keys		+prctl.sh -a43
prctl-pac-enabled-keys-Xabbrev	+prctl.sh -a43 -Xabbrev
prctl-pac-enabled-keys-Xraw	+prctl.sh -a24 -Xraw
prctl-pac-enabled-keys-Xverbose	+prctl.sh -a54 -Xverbose
prctl-pac-enabled-keys-success		+prctl-success.sh PRCTL_INJECT_RETVALS="0 1 30 0xbeef0" -a43
prctl-pac-enabled-keys-success-Xabbrev	+prctl-success.sh PRCTL_INJECT_RETVALS="0 1 30 0xbeef0" -a43 -Xabbrev
prctl-pac-enabled-keys-success-Xraw	+prctl-success.sh PRCTL_INJECT_RETVALS="0 1 30 0xbeef0" -a24 -Xraw
prctl-pac-enabled-keys-success-Xverbose	+prctl-success.sh PRCTL_INJECT_RETVALS="0 1 30 0xbeef0" -a54 -Xverbose
prctl-pac-reset-keys	+prctl.sh -a43
prctl-pdeathsig		+prctl.sh -a30
prctl-ppc-dexcr			+prctl.sh -a52
prctl-ppc-dexcr-Xabbrev		+prctl.sh -Xabbrev -a52
prctl-ppc-dexcr-Xraw		+prctl.sh -Xraw -a20
prctl-ppc-dexcr-Xverbose	+prctl.sh -Xverbose -a71
prctl-ppc-dexcr-success			+prctl-success.sh PRCTL_INJECT_RETVALS="0 1 2 3 23 42 96 224 0x5a7ebee5 0x57ae57e9" -a52
prctl-ppc-dexcr-success-Xabbrev		+prctl-success.sh PRCTL_INJECT_RETVALS="0 1 2 3 23 42 96 224 0x5a7ebee5 0x57ae57e9" -a52 -Xabbrev
prctl-ppc-dexcr-success-Xraw		+prctl-success.sh PRCTL_INJECT_RETVALS="0 1 2 3 23 42 96 224 0x5a7ebee5 0x57ae57e9" -a20 -Xraw
prctl-ppc-dexcr-success-Xverbose	+prctl-success.sh PRCTL_INJECT_RETVALS="0 1 2 3 23 42 96 224 0x5a7ebee5 0x57ae57e9" -a71 -Xverbose
prctl-riscv-icache-flush-ctx		+prctl.sh -a91
prctl-riscv-icache-flush-ctx-Xabbrev	+prctl.sh -a91 -Xabbrev
prctl-riscv-icache-flush-ctx-Xraw	+prctl.sh -a18 -Xraw
prctl-riscv-icache-flush-ctx-Xverbose	+prctl.sh -a106 -Xverbose
prctl-riscv-v-ctrl		+prctl.sh -a30
prctl-riscv-v-ctrl-Xabbrev	+prctl.sh -Xabbrev -a30
prctl-riscv-v-ctrl-Xraw		+prctl.sh -Xraw -a12
prctl-riscv-v-ctrl-Xverbose	+prctl.sh -Xverbose -a40
prctl-riscv-v-ctrl-success		+prctl-success.sh PRCTL_INJECT_RETVALS="0 6 11 12 17 31 32 42 0x57ae57f4" -a30
prctl-riscv-v-ctrl-success-Xabbrev	+prctl-success.sh PRCTL_INJECT_RETVALS="0 6 11 12 17 31 32 42 0x57ae57f4" -a30 -Xabbrev
prctl-riscv-v-ctrl-success-Xraw		+prctl-success.sh PRCTL_INJECT_RETVALS="0 6 11 12 17 31 32 42 0x57ae57f4" -a12 -Xraw
prctl-riscv-v-ctrl-success-Xverbose	+prctl-success.sh PRCTL_INJECT_RETVALS="0 6 11 12 17 31 32 42 0x57ae57f4" -a40 -Xverbose
prctl-sched-core		+prctl.sh -a71
prctl-sched-core--pidns-translation		test_pidns -etrace=prctl -a73 "QUIRK:START-OF-TEST-OUTPUT:prctl(0xffffffff /* PR_??? */, 0xfffffffe, 0xfffffffd, 0xfffffffc, 0xfffffffb)"
prctl-sched-core--pidns-translation-Xabbrev	test_pidns -etrace=prctl -a73 "QUIRK:START-OF-TEST-OUTPUT:prctl(0xffffffff /* PR_??? */, 0xfffffffe, 0xfffffffd, 0xfffffffc, 0xfffffffb)" -Xabbrev
prctl-sched-core--pidns-translation-Xraw	test_pidns -etrace=prctl -a30 "QUIRK:START-OF-TEST-OUTPUT:prctl(0xffffffff, 0xfffffffe, 0xfffffffd, 0xfffffffc, 0xfffffffb)" -Xraw
prctl-sched-core--pidns-translation-Xverbose	test_pidns -etrace=prctl -a85 "QUIRK:START-OF-TEST-OUTPUT:prctl(0xffffffff /* PR_??? */, 0xfffffffe, 0xfffffffd, 0xfffffffc, 0xfffffffb)" -Xverbose
prctl-sched-core-Xabbrev	+prctl.sh -a71 -Xabbrev
prctl-sched-core-Xraw		+prctl.sh -a28 -Xraw
prctl-sched-core-Xverbose	+prctl.sh -a83 -Xverbose
prctl-sched-core-success		+prctl-success.sh PRCTL_INJECT_RETVALS=0 -a71
prctl-sched-core-success--pidns-translation		check_scno_tampering; test_pidns -einject=prctl:when=256+:retval=0 -etrace=prctl -a73 "QUIRK:START-OF-TEST-OUTPUT:prctl(0xffffffff /* PR_??? */, 0xfffffffe, 0xfffffffd, 0xfffffffc, 0xfffffffb)"
prctl-sched-core-success--pidns-translation-Xabbrev	check_scno_tampering; test_pidns -einject=prctl:when=256+:retval=0 -etrace=prctl -a73 "QUIRK:START-OF-TEST-OUTPUT:prctl(0xffffffff /* PR_??? */, 0xfffffffe, 0xfffffffd, 0xfffffffc, 0xfffffffb)" -Xabbrev
prctl-sched-core-success--pidns-translation-Xraw	check_scno_tampering; test_pidns -einject=prctl:when=256+:retval=0 -etrace=prctl -a30 "QUIRK:START-OF-TEST-OUTPUT:prctl(0xffffffff, 0xfffffffe, 0xfffffffd, 0xfffffffc, 0xfffffffb)" -Xraw
prctl-sched-core-success--pidns-translation-Xverbose	check_scno_tampering; test_pidns -einject=prctl:when=256+:retval=0 -etrace=prctl -a85 "QUIRK:START-OF-TEST-OUTPUT:prctl(0xffffffff /* PR_??? */, 0xfffffffe, 0xfffffffd, 0xfffffffc, 0xfffffffb)" -Xverbose
prctl-sched-core-success-Xabbrev	+prctl-success.sh PRCTL_INJECT_RETVALS=0 -a71 -Xabbrev
prctl-sched-core-success-Xraw		+prctl-success.sh PRCTL_INJECT_RETVALS=0 -a28 -Xraw
prctl-sched-core-success-Xverbose	+prctl-success.sh PRCTL_INJECT_RETVALS=0 -a83 -Xverbose
prctl-seccomp-filter-v	+prctl.sh -v
prctl-securebits	+prctl.sh -a25
prctl-securebits-success		+prctl-success.sh PRCTL_INJECT_RETVALS="0 1 42 255 256 511" -a25
prctl-securebits-success-Xabbrev	+prctl-success.sh PRCTL_INJECT_RETVALS="0 1 42 255 256 511" -a25 -Xabbrev
prctl-securebits-success-Xraw		+prctl-success.sh PRCTL_INJECT_RETVALS="0 1 42 255 256 511" -a12 -Xraw
prctl-securebits-success-Xverbose	+prctl-success.sh PRCTL_INJECT_RETVALS="0 1 42 255 256 511" -a36 -Xverbose
prctl-set-ptracer-success		+prctl-success.sh PRCTL_INJECT_RETVALS=0 -a25
prctl-set-ptracer-success--pidns-translation		check_scno_tampering; test_pidns -einject=prctl:when=256+:retval=0 -etrace=prctl -a31 "QUIRK:START-OF-TEST-OUTPUT:prctl(0xffffffff /* PR_??? */, 0xfffffffe, 0xfffffffd, 0xfffffffc, 0xfffffffb)"
prctl-set-ptracer-success-Xabbrev	+prctl-success.sh PRCTL_INJECT_RETVALS=0 -a25 -Xabbrev
prctl-set-ptracer-success-Xabbrev--pidns-translation	check_scno_tampering; test_pidns -einject=prctl:when=256+:retval=0 -etrace=prctl -a31 "QUIRK:START-OF-TEST-OUTPUT:prctl(0xffffffff /* PR_??? */, 0xfffffffe, 0xfffffffd, 0xfffffffc, 0xfffffffb)" -Xabbrev
prctl-set-ptracer-success-Xraw		+prctl-success.sh PRCTL_INJECT_RETVALS=0 -a20 -Xraw
prctl-set-ptracer-success-Xraw--pidns-translation	check_scno_tampering; test_pidns -einject=prctl:when=256+:retval=0 -etrace=prctl -a27 "QUIRK:START-OF-TEST-OUTPUT:prctl(0xffffffff, 0xfffffffe, 0xfffffffd, 0xfffffffc, 0xfffffffb)" -Xraw
prctl-set-ptracer-success-Xverbose	+prctl-success.sh PRCTL_INJECT_RETVALS=0 -a42 -Xverbose
prctl-set-ptracer-success-Xverbose--pidns-translation	check_scno_tampering; test_pidns -einject=prctl:when=256+:retval=0 -etrace=prctl -a48 "QUIRK:START-OF-TEST-OUTPUT:prctl(0xffffffff /* PR_??? */, 0xfffffffe, 0xfffffffd, 0xfffffffc, 0xfffffffb)" -Xverbose
prctl-set_vma	+prctl.sh
prctl-sme			+prctl.sh -a21
prctl-sme-Xabbrev		+prctl.sh -a21 -Xabbrev
prctl-sme-Xraw			+prctl.sh -a12 -Xraw
prctl-sme-Xverbose		+prctl.sh -a32 -Xverbose
prctl-sme-success		+prctl-success.sh PRCTL_INJECT_RETVALS="0 0xdead 0x10000 0x4ea57 0x20000 0xba9000 0xdec0ded" -a21
prctl-sme-success-Xabbrev	+prctl-success.sh PRCTL_INJECT_RETVALS="0 0xdead 0x10000 0x4ea57 0x20000 0xba90000 0xdec0ded" -a21 -Xabbrev
prctl-sme-success-Xraw		+prctl-success.sh PRCTL_INJECT_RETVALS="0 0xdead 0x10000 0x4ea57 0x20000 0xba90000 0xdec0ded" -a12 -Xraw
prctl-sme-success-Xverbose	+prctl-success.sh PRCTL_INJECT_RETVALS="0 0xdead 0x10000 0x4ea57 0x20000 0xba90000 0xdec0ded" -a32 -Xverbose
prctl-spec-inject	+prctl-success.sh PRCTL_INJECT_RETVALS="error=ENOTTY 0 1 3 8 16 32 42" -a50
prctl-sve		+prctl.sh -a21
prctl-sve-Xabbrev		+prctl.sh -a21 -Xabbrev
prctl-sve-Xraw			+prctl.sh -a12 -Xraw
prctl-sve-Xverbose		+prctl.sh -a32 -Xverbose
prctl-sve-success		+prctl-success.sh PRCTL_INJECT_RETVALS="0 0xdead 0x10000 0x4ea57 0x20000 0xba9000 0xdec0ded" -a21
prctl-sve-success-Xabbrev	+prctl-success.sh PRCTL_INJECT_RETVALS="0 0xdead 0x10000 0x4ea57 0x20000 0xba90000 0xdec0ded" -a21 -Xabbrev
prctl-sve-success-Xraw		+prctl-success.sh PRCTL_INJECT_RETVALS="0 0xdead 0x10000 0x4ea57 0x20000 0xba90000 0xdec0ded" -a12 -Xraw
prctl-sve-success-Xverbose	+prctl-success.sh PRCTL_INJECT_RETVALS="0 0xdead 0x10000 0x4ea57 0x20000 0xba90000 0xdec0ded" -a32 -Xverbose
prctl-syscall-user-dispatch	+prctl.sh -a68
prctl-tagged-addr		+prctl.sh -a43
prctl-tagged-addr-Xabbrev	+prctl.sh -Xabbrev -a43
prctl-tagged-addr-Xraw		+prctl.sh -Xraw -a24
prctl-tagged-addr-Xverbose	+prctl.sh -Xverbose -a54
prctl-tagged-addr-success		+prctl-success.sh PRCTL_INJECT_RETVALS="0 1 2 3 4 5 6 7 8 13 42 0xbeef 0x57ae57f4" -a43
prctl-tagged-addr-success-Xabbrev	+prctl-success.sh PRCTL_INJECT_RETVALS="0 1 2 3 4 5 6 7 8 13 42 0xbeef 0x57ae57f4" -a43 -Xabbrev
prctl-tagged-addr-success-Xraw		+prctl-success.sh PRCTL_INJECT_RETVALS="0 1 2 3 4 5 6 7 8 13 42 0xbeef 0x57ae57f4" -a24 -Xraw
prctl-tagged-addr-success-Xverbose	+prctl-success.sh PRCTL_INJECT_RETVALS="0 1 2 3 4 5 6 7 8 13 42 0xbeef 0x57ae57f4" -a54 -Xverbose
prctl-tid_address	+prctl.sh -a23
prctl-tsc		+prctl.sh -a24
prctl-unalign		+prctl.sh -a28
pread64-pwrite64	-a21 -eread=0 -ewrite=1 -e trace=pread64,pwrite64 -P pread64-pwrite64-tmpfile -P /dev/zero -P /dev/null
preadv	-a21
preadv-pwritev	-a19 -eread=0 -ewrite=1 -e trace=preadv,pwritev
preadv2-pwritev2	-a22 -eread=0 -ewrite=1 -e trace=preadv2,pwritev2
printpath-umovestr	-a11 -e signal=none -e trace=chdir
printpath-umovestr-peekdata	-a11 -e signal=none -e trace=chdir
printpath-umovestr-undumpable	-a11 -e signal=none -e trace=chdir
printsignal-Xabbrev	-a11 -Xabbrev -e signal=none -e trace=kill
printsignal-Xraw	-a11 -Xraw -e signal=none -e trace=kill
printsignal-Xverbose	-a11 -Xverbose -e signal=none -e trace=kill
printstr	-e trace=writev
printstrn-umoven	-s4096 -e signal=none -e trace=add_key
printstrn-umoven-peekdata	-e signal=none -e trace=add_key
printstrn-umoven-undumpable	-e signal=none -e trace=add_key
prlimit64			-a36 "QUIRK:START-OF-TEST-OUTPUT:prlimit64(0, 0x10 /* RLIMIT_??? */, NULL, NULL)"
prlimit64--pidns-translation	test_pidns -a36 -e trace=prlimit64 "QUIRK:START-OF-TEST-OUTPUT:prlimit64(0, 0x10 /* RLIMIT_??? */, NULL, NULL)"
prlimit64-success			check_scno_tampering; run_strace_match_diff -a36 -einject=prlimit64:retval=42:when=256+ -etrace=prlimit64 "QUIRK:START-OF-TEST-OUTPUT:prlimit64(0, 0x10 /* RLIMIT_??? */, NULL, NULL)"
prlimit64-success--pidns-translation	check_scno_tampering; test_pidns -a36 -einject=prlimit64:retval=42:when=256+ -etrace=prlimit64 "QUIRK:START-OF-TEST-OUTPUT:prlimit64(0, 0x10 /* RLIMIT_??? */, NULL, NULL)"
process_madvise
process_madvise-y	--trace=process_madvise -y
process_madvise-yy	--trace=process_madvise -yy
process_mrelease	-a24
process_mrelease-y	-e trace=process_mrelease -y -a24 </dev/full
process_vm_readv	-s5 -a37
process_vm_readv--pidns-translation	test_pidns -s5 -a37 -e trace=process_vm_readv
process_vm_writev	-s5 -a38
process_vm_writev--pidns-translation	test_pidns -s5 -a38 -e trace=process_vm_writev
pselect6
pselect6_time64
ptrace	-a23 -s64 -e signal=none
ptrace-Xabbrev	-a23 -s64 -e signal=none -e trace=ptrace -Xabbrev
ptrace-Xraw	-a10 -s64 -e signal=none -e trace=ptrace -Xraw
ptrace-Xverbose	-a23 -s64 -e signal=none -e trace=ptrace -Xverbose
ptrace-y		-a23 -s64 -y -e signal=none -e trace=ptrace
ptrace-y-Xabbrev	-a23 -s64 -y -e signal=none -e trace=ptrace -Xabbrev
ptrace-y-Xraw		-a10 -s64 -y -e signal=none -e trace=ptrace -Xraw
ptrace-y-Xverbose	-a23 -s64 -y -e signal=none -e trace=ptrace -Xverbose
ptrace_set_syscall_info			--trace=ptrace
ptrace_set_syscall_info-Xabbrev		--trace=ptrace -Xabbrev
ptrace_set_syscall_info-Xraw		-a28 --trace=ptrace -Xraw
ptrace_set_syscall_info-Xverbose	--trace=ptrace -Xverbose
ptrace_syscall_info	-a35 -e signal=none -e trace=ptrace
ptrace_syscall_info-Xabbrev	-a35 -e signal=none -e trace=ptrace -Xabbrev
ptrace_syscall_info-Xraw	-a26 -e signal=none -e trace=ptrace -Xraw
ptrace_syscall_info-Xverbose	-a47 -e signal=none -e trace=ptrace -Xverbose
pwritev	-a22 -s7
quotactl
quotactl-Xabbrev	-Xabbrev -e trace=quotactl
quotactl-Xraw	-a27 -Xraw -e trace=quotactl
quotactl-Xverbose	-Xverbose -e trace=quotactl
quotactl-success	-einject=quotactl:retval=42 -etrace=quotactl
quotactl-success-v	-einject=quotactl:retval=42 -etrace=quotactl -v
quotactl-v	-v -e trace=quotactl
quotactl-xfs	-e trace=quotactl
quotactl-xfs-success	-einject=quotactl:retval=42 -etrace=quotactl
quotactl-xfs-success-v	-einject=quotactl:retval=42 -etrace=quotactl -v
quotactl-xfs-v	-v -e trace=quotactl
quotactl_fd
quotactl_fd-P	--trace=quotactl_fd -P /dev/full
quotactl_fd-y	--trace=quotactl_fd -y
read-write	-a15 -eread=0,5 -ewrite=1,4 -e trace=read,write -P read-write-tmpfile -P /dev/zero -P /dev/null
readahead	-a1
readdir	-a16
readlink	-xx
readlinkat	-xx
reboot		-s 256
recv-MSG_TRUNC	-a26 -e trace=recv
recvfrom	-a35
recvfrom-MSG_TRUNC	-e trace=recvfrom
recvmmsg-timeout	-a25 -e trace=recvmmsg
recvmsg	-eread=0 -ewrite=1 -e trace=recvmsg,sendmsg
regex	test_trace_expr '' -etrace='/^(.*_)?statv?fs'
remap_file_pages
remap_file_pages-Xabbrev	-Xabbrev -e trace=remap_file_pages
remap_file_pages-Xraw	-Xraw -e trace=remap_file_pages
remap_file_pages-Xverbose	-Xverbose -e trace=remap_file_pages
removexattrat
removexattrat-P	--trace=removexattrat -P /dev/full
removexattrat-y	--trace=removexattrat -y
removexattrat-yy	--trace=removexattrat -yy
rename	-a35
renameat
renameat2
request_key	-a33 -s12
riscv_flush_icache	-a34
rmdir	-a22
rt_sigpending	-a20
rt_sigprocmask
rt_sigqueueinfo	-esignal=none
rt_sigqueueinfo--pidns-translation	test_pidns -esignal=none -e trace=rt_sigqueueinfo
rt_sigreturn	-esignal='!USR1'
rt_sigsuspend	-a20 -esignal=none
rt_sigtimedwait	-a38
rt_tgsigqueueinfo	-esignal=none
rt_tgsigqueueinfo--pidns-translation	test_pidns -esignal=none -e trace=rt_tgsigqueueinfo
s390_guarded_storage	-a32
s390_guarded_storage-v	-e trace=s390_guarded_storage -a32 -v
s390_pci_mmio_read_write	-e trace=s390_pci_mmio_read,s390_pci_mmio_write -a30
s390_runtime_instr	-a44
s390_sthyi	-a47
s390_sthyi-v	-e trace=s390_sthyi -a47 -v
sched	test_trace_expr 'times|times-.*' -e/sched
sched_get_priority_mxx	-a33 -e trace=sched_get_priority_min,sched_get_priority_max
sched_rr_get_interval	-a31
sched_xetaffinity	-a28 -e trace=sched_getaffinity,sched_setaffinity
sched_xetaffinity--pidns-translation	test_pidns -a28 -e trace=sched_getaffinity,sched_setaffinity
sched_xetattr	-a29 -e trace=sched_getattr,sched_setattr
sched_xetattr--pidns-translation	test_pidns -a29 -e trace=sched_getattr,sched_setattr
sched_xetparam	-a23 -e trace=sched_getparam,sched_setparam
sched_xetparam--pidns-translation	test_pidns -a23 -e trace=sched_getparam,sched_setparam
sched_xetscheduler	-a22 -e trace=sched_getscheduler,sched_setscheduler
sched_xetscheduler--pidns-translation	test_pidns -a22 -e trace=sched_getscheduler,sched_setscheduler
sched_yield	-a14
scm_credentials	--trace=recvmsg
scm_pidfd	--trace=recvmsg -y
scm_pidfd-success	--inject=recvmsg:retval=1 --trace=recvmsg -y
seccomp-filter	-e trace=seccomp
seccomp-filter-v	-v -e trace=seccomp
seccomp_get_action_avail	-e trace=seccomp
seccomp_get_notif_sizes		-etrace=seccomp -a42
seccomp_get_notif_sizes-success	-einject=seccomp:retval=42 -etrace=seccomp -a42
segv_accerr	-qq --trace=none
segv_pkuerr	-qq --trace=none
select	-a36
select-P	-a36 -e trace=select -P /dev/full 9>>/dev/full
select-trace-fd-7	-a36 -e trace=select -e trace-fd=7 7>>/dev/null 9>>/dev/full
select-trace-fd-7-9	-a36 -e trace=select -e trace-fd=7,9 7>>/dev/null 9>>/dev/full
select-trace-fd-7-P	-a36 -e trace=select -e trace-fd=7 -P /dev/full 7>>/dev/null 9>>/dev/full
semop	-a32
semop-indirect	-a32 -e trace=semop
semtimedop
semtimedop-ipc	-e trace=semtimedop
semtimedop_time64
sendfile	-a27
sendfile64	-a29
set_mempolicy	-a34 -s3
set_mempolicy-Xabbrev	-a34 -s3 -Xabbrev -e trace=set_mempolicy
set_mempolicy-Xraw	-a24 -s3 -Xraw -e trace=set_mempolicy
set_mempolicy-Xverbose	-s3 -Xverbose -e trace=set_mempolicy
set_mempolicy_home_node	-a39
setdomainname	-a24
setfsgid	-a12
setfsgid32	-a14
setfsuid	-a12
setfsuid32	-a14
setgid	-a10
setgid32	-a12
setgroups	-s2 -a17
setgroups32	-s2 -a19
sethostname	-a22
setns	-a21
setregid	-a15
setregid32	-a17
setresgid	-a19
setresgid32	-a21
setresuid	-a19
setresuid32	-a21
setreuid	-a15
setreuid32	-a17
setrlimit	-a27
setrlimit-Xabbrev	-a27 -e trace=setrlimit -Xabbrev
setrlimit-Xraw	-a19 -e trace=setrlimit -Xraw
setrlimit-Xverbose	-a36 -e trace=setrlimit -Xverbose
setuid	-a10
setuid32	-a12
setxattrat
setxattrat-P	--trace=setxattrat -P /dev/full
setxattrat-y	--trace=setxattrat -y
setxattrat-yy	--trace=setxattrat -yy
shmxt	-a11 -e trace='/(osf_)?shmat,shmdt'
shutdown	-a24
sigaction	-a31
siginfo	-e trace=none
signal	-a25 -e signal=none -e trace='/^signal$'
signal_receive	-a16 -e trace=kill
signal_receive--pidns-translation	test_pidns -a16 -e trace=kill
signalfd4	-a32
signalfd4-yy	--trace=signalfd4 -yy
sigpending	-a15
sigprocmask	-a34
sigreturn	-esignal='!USR1'
sigsuspend	-a19 -esignal=none
so_error	-e trace=getsockopt
so_linger	-e trace=getsockopt,setsockopt
so_peercred	-e trace=getsockopt
so_peercred--pidns-translation	test_pidns -e trace=getsockopt
so_peercred-Xabbrev	-e trace=getsockopt -Xabbrev
so_peercred-Xraw	-e trace=getsockopt -Xraw -a39
so_peercred-Xverbose	-e trace=getsockopt -Xverbose
so_peerpidfd	--trace=getsockopt -y
sock_filter-v	-v -e trace=getsockopt,setsockopt
sock_filter-v-Xabbrev	-v -e trace=getsockopt,setsockopt -X abbrev
sock_filter-v-Xraw	-a 37 -v -e trace=getsockopt,setsockopt -X raw
sock_filter-v-Xverbose	-v -e trace=getsockopt,setsockopt -X verbose
sockaddr_xlat-Xabbrev	-Xabbrev -e trace=connect -a22
sockaddr_xlat-Xabbrev-y		-Xabbrev -y -e trace=connect -a22 </dev/null 7>/dev/zero
sockaddr_xlat-Xraw	-Xraw -e trace=connect -a22
sockaddr_xlat-Xraw-y		-Xraw -y -e trace=connect -a22 </dev/null 7>/dev/zero
sockaddr_xlat-Xverbose	-Xverbose -e trace=connect -a22
sockaddr_xlat-Xverbose-y	-Xverbose -y -e trace=connect -a22 </dev/null 7>/dev/zero
socketcall	-a20
sockopt-sol_netlink	-e trace=getsockopt,setsockopt
sockopt-sol_socket			-e trace=getsockopt,setsockopt
sockopt-sol_socket-Xabbrev		-e trace=getsockopt,setsockopt -Xabbrev
sockopt-sol_socket-Xraw			-e trace=getsockopt,setsockopt -Xraw -a32
sockopt-sol_socket-Xverbose		-e trace=getsockopt,setsockopt -Xverbose
sockopt-sol_socket-success		-einject=getsockopt,setsockopt:retval=42 -etrace=getsockopt,setsockopt
sockopt-sol_socket-success-Xabbrev	-einject=getsockopt,setsockopt:retval=42 -etrace=getsockopt,setsockopt -Xabbrev
sockopt-sol_socket-success-Xraw		-einject=getsockopt,setsockopt:retval=42 -etrace=getsockopt,setsockopt -Xraw -a32
sockopt-sol_socket-success-Xverbose	-einject=getsockopt,setsockopt:retval=42 -etrace=getsockopt,setsockopt -Xverbose
sockopt-timestamp	-e trace=recvmsg
splice
stat	-a30 --no-abbrev --trace-path=stat.sample --trace-path=/dev/full
stat64	-a32 --no-abbrev --trace-path=stat.sample --trace-path=/dev/full
statfs	-a17
statfs64	-a23
statmount	-a28
statmount-success --inject=statmount:retval=42 -a28 --trace=statmount
status-all	-a10 -e trace=chdir --status=detached,failed,successful,unavailable,unfinished
status-failed	-a10 -e trace=chdir -Z
status-failed-long	-a10 -e trace=chdir --failed-only
status-failed-status	-a10 -e trace=chdir -e status=failed
status-none	-e trace=all --status=none
status-successful	-a10 -e trace=chdir -z
status-successful-long	-a10 -e trace=chdir --successful-only
status-successful-status	-a10 -e trace=chdir --status=successful
status-unfinished	-a10 -e trace=all --status=unfinished
statx	-a32 --no-abbrev --trace-path=stat.sample --trace-path=/dev/full
strace--absolute-timestamps +strace-t.test --absolute-timestamps
strace--absolute-timestamps-format-time +strace-t.test --absolute-timestamps=format:time
strace--absolute-timestamps-format-time-precision-ms +strace-tt.test 3 --absolute-timestamps=format:time --absolute-timestamps=precision:ms
strace--absolute-timestamps-format-time-precision-ns +strace-tt.test 9 --absolute-timestamps=format:time --absolute-timestamps=precision:ns
strace--absolute-timestamps-format-time-precision-s +strace-t.test --absolute-timestamps=format:time --absolute-timestamps=precision:s
strace--absolute-timestamps-format-time-precision-us +strace-tt.test 6 --absolute-timestamps=format:time --absolute-timestamps=precision:us
strace--absolute-timestamps-format-unix-precision-ms +strace-ttt.test 3 --absolute-timestamps=precision:ms --absolute-timestamps=format:unix
strace--absolute-timestamps-format-unix-precision-ns +strace-ttt.test 9 --absolute-timestamps=format:unix --absolute-timestamps=precision:ns
strace--absolute-timestamps-format-unix-precision-s +strace-ttt.test 0 --absolute-timestamps=format:unix --absolute-timestamps=precision:s
strace--absolute-timestamps-format-unix-precision-us +strace-ttt.test 6 --absolute-timestamps=precision:us --absolute-timestamps=format:unix
strace--always-show-pid	--always-show-pid --trace=fchdir -a15
strace--decode-pids-comm	--decode-pids=comm --trace=getppid,tgkill --signal='!SIGCHLD,SIGCONT' -q -f -a 18
strace--follow-forks-output-separately +strace-ff.test --follow-forks --output-separately
strace--relative-timestamps +strace-r.test --relative-timestamps
strace--relative-timestamps-ms +strace-r.test --relative-timestamps=ms
strace--relative-timestamps-ns +strace-r.test --relative-timestamps=ns
strace--relative-timestamps-s +strace-r.test --relative-timestamps=s
strace--relative-timestamps-us +strace-r.test --relative-timestamps=us
strace--strings-in-hex			--trace=chdir --strings-in-hex --columns=18
strace--strings-in-hex-all		--trace=chdir --strings-in-hex=all --columns=18
strace--strings-in-hex-non-ascii	--trace=chdir --strings-in-hex=non-ascii --columns=12
strace--strings-in-hex-non-ascii-chars	--trace=chdir --strings-in-hex=non-ascii-chars --columns=12
strace--strings-in-hex-none		--trace=chdir --strings-in-hex=none --columns=12
strace--syscall-limit-c		+strace--syscall-limit.test -c -S syscall -U calls
strace--syscall-limit-path	+strace--syscall-limit.test --trace-path=invalid.dir
strace--syscall-limit-status	+strace--syscall-limit.test --status=failed
strace--syscall-limit-status-c	+strace--syscall-limit.test --status=failed --syscall-limit=4 -c -S syscall -U calls
strace--syscall-limit-status-summary	+strace--syscall-limit.test --status=failed --syscall-limit=4 --summary -S syscall -U calls
strace--syscall-limit-summary	+strace--syscall-limit.test -C -S syscall -U calls
strace--syscall-times +strace-T_upper.test --syscall-times
strace--syscall-times-ms +strace-T_upper.test --syscall-times=ms
strace--syscall-times-ns +strace-T_upper.test --syscall-times=ns
strace--syscall-times-s +strace-T_upper.test --syscall-times=s
strace--syscall-times-us +strace-T_upper.test --syscall-times=us
strace--timestamps +strace-t.test --timestamps
strace--timestamps-time +strace-t.test --timestamps=time
strace--timestamps-time-ms +strace-tt.test 3 --timestamps=time,ms
strace--timestamps-time-ns +strace-tt.test 9 --timestamps=time,ns
strace--timestamps-time-s +strace-t.test --timestamps=time,s
strace--timestamps-time-us +strace-tt.test 6 --timestamps=time,us
strace--timestamps-unix-ms +strace-ttt.test 3 --timestamps=unix,ms
strace--timestamps-unix-ns +strace-ttt.test 9 --timestamps=unix,ns
strace--timestamps-unix-s +strace-ttt.test 0 --timestamps=unix,s
strace--timestamps-unix-us +strace-ttt.test 6 --timestamps=unix,us
strace-Y-0123456789	-Y --trace=getppid,tgkill --signal='!SIGCHLD,SIGCONT' -q -f -a 18
strace-n	-e trace=listen -n -qq -a 12
strace-no-x	-e trace=chdir -a 12
strace-x	-e trace=chdir -x -a 12
strace-xx	-e trace=chdir -xx -a 18
swap	-a23 -e trace=swapon,swapoff
sxetmask	-a11 -e trace=sgetmask,ssetmask
symlink		-a20
symlink-P	-a32 -e trace=symlink -P "symlink.sample"
symlinkat
sync	-a7
sync_file_range
sync_file_range2
sysctl	-a16 --trace=_sysctl
sysinfo	-a14
syslog	-a35
tcp_ao	-e trace=getsockopt,setsockopt
tee
tgkill	-a15 --signal='!cont'
tgkill--pidns-translation       test_pidns -a15 --signal='!cont' -e trace=tgkill
threads-execve--quiet-thread-execve +threads-execve.test -s40 --quiet=personality,thread-execve
threads-execve-q +threads-execve.test -q
threads-execve-qq +threads-execve.test -qq
threads-execve-qqq +threads-execve.test -qqq
time	-a10
timer_create
timer_xettime	-e trace=timer_create,timer_settime,timer_gettime
timerfd_xettime	-e trace=timerfd_create,timerfd_settime,timerfd_gettime
times	-esignal=none
times-Xabbrev	-esignal=none -e trace=times -Xabbrev
times-Xraw	-esignal=none -e trace=times -Xraw
times-Xverbose	-esignal=none -e trace=times -Xverbose
times-fail	-a12 -e trace=times
tkill	-a12 --signal='!cont'
tkill--pidns-translation       test_pidns --signal='!cont' -a12 -e trace=tkill
trace_clock	test_trace_expr 'clock_nanosleep|times|times-.*' -e%clock
trace_creds	test_trace_expr '([gs]et[^p]*([gu]id|groups)|caps|prctl|[fl]?chown|print(path-umovestr|strn-umoven)-undumpable|ptrace|quotactl|rt_sigtimedwait|rt_(tg)?sigqueueinfo).*' -e%creds
trace_fstat	test_trace_expr '' -e%fstat -v -P stat.sample -P /dev/full
trace_fstatfs	test_trace_expr '' -e%fstatfs
trace_lstat	test_trace_expr '' -e%lstat -v -P stat.sample -P /dev/full
trace_personality_32	+qualify_personality.sh 32 'getcwd' 'fsync-y|poke'
trace_personality_64	+qualify_personality.sh 64 'getcwd' 'fsync-y|poke'
trace_personality_all_32	+qualify_personality_all.sh 32
trace_personality_all_64	+qualify_personality_all.sh 64
trace_personality_all_x32	+qualify_personality_all.sh x32
trace_personality_number_32	+qualify_personality.sh 32 "$(${srcdir=.}/print_scno_getcwd.sh)" 'fsync-y|poke'
trace_personality_number_64	+qualify_personality.sh 64 "$(${srcdir=.}/print_scno_getcwd.sh)" 'fsync-y|poke'
trace_personality_number_x32	+qualify_personality.sh x32 "$(${srcdir=.}/print_scno_getcwd.sh)" 'fsync-y|poke'
trace_personality_regex_32	+qualify_personality.sh 32 '/clock.*' 'times|times-.*|fcntl.*'
trace_personality_regex_64	+qualify_personality.sh 64 '/clock.*' 'times|times-.*|fcntl.*'
trace_personality_regex_x32	+qualify_personality.sh x32 '/clock.*' 'times|times-.*|fcntl.*'
trace_personality_statfs_32	+qualify_personality.sh 32 '%statfs'
trace_personality_statfs_64	+qualify_personality.sh 64 '%statfs'
trace_personality_statfs_x32	+qualify_personality.sh x32 '%statfs'
trace_personality_x32	+qualify_personality.sh x32 'getcwd' 'fsync-y|poke'
trace_question	test_trace_expr '' -e?osf_utimes,?/^pkey_.*
trace_stat	test_trace_expr '' -e%stat -v -P stat.sample -P /dev/full
trace_stat_like	test_trace_expr '' -e%%stat -v -P stat.sample -P /dev/full
trace_statfs	test_trace_expr '' -e%statfs
trace_statfs_like	test_trace_expr '' -e%%statfs
trie_test    run_prog
truncate
truncate64
ugetrlimit	-a28 'QUIRK:START-OF-TEST-OUTPUT:ugetrlimit(0x10 /* RLIMIT_??? */, NULL)'
umask	-a11
umoven-illptr	-a36 -e trace=nanosleep
umovestr-illptr	-a11 -e trace=chdir
umovestr3	-a14 -e trace=chdir
umovestr_cached_adjacent	+umovestr_cached.test 3
unlink	-a24
unlinkat	-a35
unshare	-a11
userfaultfd	-a15
ustat	-a33
utime	-a16
utimensat	-a33
utimensat-Xabbrev	-a33 -Xabbrev -e trace=utimensat
utimensat-Xraw	-a29 -Xraw -e trace=utimensat
utimensat-Xverbose	-a44 -Xverbose -e trace=utimensat
utimes	-a17
vfork-f	-a26 -qq -f -e signal=none -e trace=chdir
vhangup	-a10
vmsplice	-ewrite=1
wait4	-esignal=none
wait4-v	-v -e signal=none -e trace=wait4
waitid	-esignal=none
waitid-Y	-Y -e signal=none -e trace=waitid
waitid-v	-v -e signal=none -e trace=waitid
waitpid	-a28
xattr	-a22 -e trace=getxattr,fgetxattr,lgetxattr,setxattr,fsetxattr,lsetxattr,listxattr,flistxattr,llistxattr,removexattr,fremovexattr,lremovexattr
xattr-strings	-a22 -s 4 -e trace=fsetxattr
xet_robust_list	-a24 -e trace=get_robust_list,set_robust_list "QUIRK:START-OF-TEST-OUTPUT:get_robust_list(0, NULL, NULL)"
xet_robust_list--pidns-translation	test_pidns -a24 -e trace=get_robust_list,set_robust_list "QUIRK:START-OF-TEST-OUTPUT:get_robust_list(0, NULL, NULL)"
xetitimer	-a29 -e trace=setitimer,getitimer
xetpgid	-a11 -e trace=getpgid,setpgid
xetpgid--pidns-translation	test_pidns -a11 -e trace=getpgid,setpgid
xetpriority	-a27 -e trace=getpriority,setpriority
xetpriority--pidns-translation	test_pidns -a27 -e trace=getpriority,setpriority
xettimeofday	-a20 -e trace=gettimeofday,settimeofday
